NO ./textures/north.xpm
SO ./textures/south.xpm
WE ./textures/west.xpm
EA ./textures/east.xpm
F 220,100,0
C 225,30,0

        1111111111111111111111111
        1000000000110000000000001
        1011000001110000000000001
        1001000000000000000000001
111111111011000001110000000000001
10000000001100000111011111011111
1111011111111101110S0000010001
11110111111111011101010010011
1100000011010101110000010001
10000000000000001100000010001
10000000000000001101010010001
110000011101011111110111000111
11110111 1110101 11111010001
11111111 1111111 111111111111