NO ./textures/north.xpm
SO ./textures/west.xpm
WE ./textures/brick.xpm
EA ./textures/east.xpm

F 176,224,230
C 1,215,88

        1111111111111111111111111
        1000000000110000000000001
        1011000001110000000000001
        1001000000P00000000000001
111111111P11000001110000000000001
10000000001100000111011111P111111
11110111111111011100000010001
1111P111111111011101010010001
11000000110101011100000010001

10000000000000001100000010001
10000000000000001101010010001
11000001110101011111011110N0111
11110111 1110101 101111010001
11111111 1111111 111111111111
